//MAP CONVERTED BY dmm2tgm.py THIS HEADER COMMENT PREVENTS RECONVERSION, DO NOT REMOVE
"aq" = (
/obj/effect/decal/cleanable/dirt,
/obj/structure/cable,
/obj/effect/decal/cleanable/ash,
/turf/open/floor/iron/small,
/area/space)
"aV" = (
/obj/machinery/atmospherics/components/tank/air,
/obj/effect/turf_decal/bot,
/obj/structure/cable,
/turf/open/floor/plating,
/area/space)
"bj" = (
/obj/effect/decal/cleanable/dirt,
/obj/machinery/atmospherics/pipe/smart/manifold4w/supply/hidden/layer4,
/turf/open/floor/plating,
/area/space)
"bt" = (
/obj/effect/decal/cleanable/dirt,
/obj/machinery/atmospherics/components/unary/vent_scrubber/on/layer2{
	dir = 8
	},
/turf/open/floor/iron/small,
/area/space)
"bW" = (
/obj/machinery/light/dim/directional/north,
/obj/item/stock_parts/subspace/filter{
	pixel_x = 4;
	pixel_y = -2
	},
/turf/open/floor/plating,
/area/space)
"cy" = (
/obj/item/chair/wood,
/obj/machinery/light/dim/directional/north,
/turf/open/floor/iron,
/area/space)
"cH" = (
/obj/machinery/washing_machine{
	pixel_x = 4
	},
/obj/structure/sign/poster/contraband/random/directional/north,
/obj/structure/window/spawner/directional/west,
/obj/effect/decal/cleanable/dirt,
/turf/open/floor/iron/small,
/area/space)
"cK" = (
/obj/effect/decal/cleanable/dirt,
/turf/open/floor/iron/dark,
/area/space)
"cO" = (
/obj/effect/decal/cleanable/dirt,
/obj/machinery/computer/libraryconsole/bookmanagement,
/obj/structure/table/reinforced,
/turf/open/floor/plating,
/area/space)
"cR" = (
/obj/effect/decal/cleanable/dirt,
/obj/structure/closet/crate/freezer,
/obj/item/reagent_containers/blood/o_minus,
/obj/item/reagent_containers/blood/o_minus{
	pixel_x = -3;
	pixel_y = 3
	},
/turf/open/floor/iron,
/area/space)
"cZ" = (
/obj/structure/table,
/obj/machinery/microwave,
/obj/machinery/light/directional/south,
/turf/open/floor/iron/small,
/area/space)
"dl" = (
/obj/structure/table,
/obj/item/reagent_containers/cup/glass/bottle/beer/almost_empty{
	name = "Use To Avert Loneliness";
	desc = "It's been used...";
	pixel_x = 8
	},
/obj/item/reagent_containers/spray/cleaner{
	pixel_x = -6
	},
/turf/open/floor/plating,
/area/space)
"ds" = (
/obj/structure/table,
/obj/machinery/cell_charger,
/obj/item/stock_parts/cell/high,
/obj/item/stack/cable_coil{
	pixel_x = 3;
	pixel_y = 10
	},
/obj/machinery/light/small/directional/west,
/obj/effect/turf_decal/tile/red/opposingcorners,
/turf/open/floor/iron/dark,
/area/space)
"dS" = (
/obj/machinery/door/airlock/centcom{
	name = "Syndicate Secure Airlock System";
	desc = "Truly, a marvel of modern engineering."
	},
/obj/structure/cable,
/obj/machinery/door/firedoor,
/obj/machinery/atmospherics/pipe/smart/manifold4w/supply/hidden/layer4,
/obj/machinery/atmospherics/pipe/smart/manifold4w/scrubbers/hidden/layer2,
/obj/effect/mapping_helpers/airlock/access/all/syndicate/general,
/obj/effect/turf_decal/tile/red/opposingcorners,
/turf/open/floor/iron/dark,
/area/space)
"eA" = (
/obj/structure/cable,
/obj/machinery/atmospherics/pipe/smart/manifold4w/scrubbers/hidden/layer2,
/obj/machinery/atmospherics/pipe/smart/manifold4w/supply/hidden/layer4,
/obj/machinery/light/small/directional/north,
/turf/open/floor/iron/small,
/area/space)
"eJ" = (
/obj/machinery/door/airlock/external/ruin{
	id_tag = "syndie_listeningpost_external_interior"
	},
/obj/effect/mapping_helpers/airlock/cyclelink_helper_multi{
	cycle_id = "syndicate_comms_base"
	},
/obj/effect/turf_decal/stripes/line{
	dir = 1
	},
/obj/effect/turf_decal/stripes/line,
/obj/structure/cable,
/turf/open/floor/plating,
/area/space)
"eW" = (
/obj/effect/decal/cleanable/dirt,
/obj/effect/turf_decal/tile/red/opposingcorners,
/obj/machinery/computer/telecomms/server/translator,
/turf/open/floor/iron/dark,
/area/space)
"ge" = (
/obj/structure/sign/departments/medbay/alt/directional/north,
/obj/effect/decal/cleanable/dirt,
/obj/effect/decal/cleanable/dirt,
/obj/machinery/iv_drip,
/obj/machinery/atmospherics/pipe/smart/manifold4w/supply/hidden/layer4,
/turf/open/floor/iron,
/area/space)
"hU" = (
/obj/machinery/telecomms/relay/preset/ruskie{
	use_power = 0
	},
/turf/open/floor/plating,
/area/space)
"ik" = (
/obj/structure/bookcase/random,
/turf/open/floor/iron/grimy,
/area/space)
"iq" = (
/obj/machinery/airalarm/directional/north,
/obj/effect/decal/cleanable/blood/old,
/obj/effect/mapping_helpers/airalarm/syndicate_access,
/turf/open/floor/iron,
/area/space)
"jl" = (
/obj/effect/turf_decal/bot,
/obj/item/weldingtool/largetank,
/obj/item/wrench,
/obj/item/clothing/head/utility/welding,
/obj/structure/rack,
/turf/open/floor/plating,
/area/space)
"jU" = (
/obj/structure/sign/nanotrasen{
	pixel_y = -32
	},
/obj/structure/sign/nanotrasen{
	pixel_x = 32
	},
/obj/structure/marker_beacon/cerulean,
/turf/open/floor/plating/airless,
/area/space)
"ls" = (
/obj/effect/turf_decal/delivery,
/obj/structure/closet/emcloset/anchored,
/turf/open/floor/plating,
/area/space)
"lv" = (
/obj/effect/decal/cleanable/dirt,
/turf/open/floor/plating,
/area/space)
"lG" = (
/obj/machinery/computer/security/telescreen/entertainment/directional/south,
/obj/structure/closet/secure_closet/freezer/empty/open,
/obj/machinery/atmospherics/pipe/smart/manifold4w/scrubbers/hidden/layer2,
/turf/open/floor/iron/small,
/area/space)
"lH" = (
/obj/structure/sign/warning/explosives/alt/directional/north,
/obj/machinery/syndicatebomb/self_destruct{
	anchored = 1
	},
/obj/machinery/door/window/brigdoor{
	req_access = list("syndicate");
	name = "Self Destruct Option"
	},
/obj/machinery/light/small/red/directional/north,
/turf/open/floor/circuit/red,
/area/space)
"lL" = (
/obj/structure/table/wood,
/obj/item/seeds/potato,
/obj/item/ammo_box/magazine/m9mm,
/turf/open/floor/iron/grimy,
/area/space)
"lX" = (
/obj/effect/turf_decal/bot,
/obj/structure/cable,
/obj/machinery/suit_storage_unit/open{
	name = "Empty E.V.A. Suit Storage";
	desc = "There's no suit inside."
	},
/obj/item/paper/fluff/ruins/listeningstation/reports/august,
/turf/open/floor/plating,
/area/space)
"mb" = (
/obj/item/paper/fluff/ruins/listeningstation/reports/june,
/turf/open/misc/asteroid/airless,
/area/space)
"mc" = (
/obj/item/bedsheet/syndie,
/obj/structure/bed,
/turf/open/floor/iron/grimy,
/area/space)
"mk" = (
/turf/closed/wall,
/area/space)
"mT" = (
/obj/structure/barricade/wooden/crude,
/obj/structure/cable,
/obj/effect/turf_decal/stripes/line{
	dir = 8
	},
/obj/machinery/atmospherics/pipe/smart/manifold4w/supply/hidden/layer4,
/obj/machinery/atmospherics/pipe/smart/manifold4w/scrubbers/hidden/layer2,
/obj/effect/mapping_helpers/broken_floor,
/obj/machinery/door/airlock{
	name = "Emergency Backup"
	},
/obj/effect/mapping_helpers/airlock/access/all/syndicate/general,
/turf/open/floor/plating,
/area/space)
"nI" = (
/obj/effect/decal/cleanable/blood/drip,
/obj/structure/table,
/obj/item/camera,
/turf/open/floor/iron,
/area/space)
"nL" = (
/obj/effect/decal/cleanable/dirt,
/obj/structure/cable,
/turf/open/floor/plating,
/area/space)
"ob" = (
/obj/structure/sign/nanotrasen{
	pixel_y = 32
	},
/obj/structure/sign/nanotrasen{
	pixel_x = 32
	},
/obj/structure/marker_beacon/cerulean,
/turf/open/floor/plating/airless,
/area/space)
"od" = (
/obj/item/wallframe/button{
	pixel_x = 7;
	pixel_y = -7;
	name = "Busted Button";
	desc = "Someone appears to have broken this button off it's frame. Not likely to be useful where you found it."
	},
/obj/effect/turf_decal/tile/blue{
	dir = 1
	},
/turf/open/floor/iron,
/area/space)
"oo" = (
/obj/structure/cable,
/obj/effect/mob_spawn/ghost_role/human/lavaland_syndicate/comms/space{
	dir = 4
	},
/turf/open/floor/iron/grimy,
/area/space)
"oU" = (
/obj/structure/bed/maint,
/obj/item/bedsheet/syndie,
/obj/item/paper/fluff/ruins/listeningstation/reports/october,
/turf/open/floor/plating,
/area/space)
"pd" = (
/obj/structure/cable,
/obj/effect/mapping_helpers/airlock/access/all/syndicate/general,
/obj/machinery/door/airlock/centcom{
	name = "Nanotrasen Real Locked Door";
	desc = "Truly, a marvel of modern engineering."
	},
/turf/open/floor/iron/dark,
/area/space)
"pp" = (
/obj/machinery/computer/records/medical/syndie{
	req_access = list("syndicate")
	},
/obj/machinery/light/small/directional/north,
/obj/effect/turf_decal/tile/red/opposingcorners,
/turf/open/floor/iron/dark,
/area/space)
"pX" = (
/obj/structure/sign/nanotrasen{
	pixel_y = -32
	},
/obj/structure/cable,
/turf/open/floor/plating/airless,
/area/space)
"qq" = (
/obj/machinery/door/airlock/maintenance,
/obj/machinery/atmospherics/pipe/smart/manifold4w/supply/hidden/layer4,
/obj/machinery/atmospherics/pipe/smart/manifold4w/scrubbers/hidden/layer2,
/obj/structure/cable,
/turf/open/floor/plating,
/area/space)
"ru" = (
/obj/structure/cable,
/obj/effect/decal/cleanable/dirt,
/obj/machinery/atmospherics/pipe/smart/manifold4w/scrubbers/hidden/layer2,
/obj/effect/spawner/random/trash/cigbutt,
/turf/open/floor/iron/small,
/area/space)
"rH" = (
/obj/effect/decal/cleanable/dirt,
/obj/structure/table,
/obj/item/storage/photo_album/listeningstation,
/turf/open/floor/iron/small,
/area/space)
"rO" = (
/obj/machinery/computer/arcade/orion_trail,
/turf/open/floor/plating,
/area/space)
"sO" = (
/obj/item/stock_parts/servo{
	pixel_y = 8;
	pixel_x = 4
	},
/turf/closed/mineral/random,
/area/space)
"sR" = (
/obj/structure/cable,
/turf/open/floor/plating/airless,
/area/space)
"sV" = (
/obj/structure/extinguisher_cabinet/directional/south,
/obj/machinery/hydroponics/soil,
/turf/open/floor/iron,
/area/space)
"te" = (
/obj/machinery/atmospherics/components/binary/valve/layer4,
/obj/effect/spawner/random/trash/mess,
/turf/open/floor/plating,
/area/space)
"tE" = (
/obj/structure/cable,
/obj/effect/decal/cleanable/dirt,
/obj/effect/turf_decal/stripes/line{
	dir = 1
	},
/obj/machinery/atmospherics/pipe/smart/manifold4w/scrubbers/hidden/layer2,
/obj/machinery/atmospherics/pipe/smart/manifold4w/supply/hidden/layer4,
/turf/open/floor/iron/small,
/area/space)
"tO" = (
/obj/structure/lattice/catwalk,
/obj/structure/sign/nanotrasen{
	pixel_x = -32
	},
/obj/structure/marker_beacon/cerulean,
/turf/template_noop,
/area/space)
"uH" = (
/obj/item/mining_scanner,
/obj/item/pickaxe,
/obj/item/clothing/mask/gas,
/obj/structure/rack,
/obj/effect/turf_decal/tile/red/opposingcorners,
/turf/open/floor/iron/dark,
/area/space)
"ve" = (
/obj/item/toy/waterballoon{
	name = "Donk Corporation's Emergency Air Supply Balloon";
	desc = "The efficacy of this product is doubted."
	},
/turf/open/misc/asteroid/airless,
/area/space)
"vr" = (
/obj/effect/decal/cleanable/dirt,
/obj/structure/chair/sofa/right/brown{
	dir = 4
	},
/obj/machinery/atmospherics/pipe/smart/manifold4w/scrubbers/hidden/layer2,
/turf/open/floor/plating,
/area/space)
"vH" = (
/obj/structure/lattice/catwalk,
/obj/machinery/atmospherics/components/unary/passive_vent/layer2{
	dir = 8
	},
/turf/template_noop,
/area/space)
"vL" = (
/obj/effect/spawner/random/trash/cigbutt,
/turf/open/floor/plating,
/area/space)
"wh" = (
/obj/structure/sink/directional/west,
/obj/machinery/shower/directional/north,
/obj/effect/decal/cleanable/dirt,
/obj/structure/mirror/directional/east,
/turf/open/floor/iron/showroomfloor,
/area/space)
"ws" = (
/obj/structure/bed,
/turf/closed/mineral/random,
/area/space)
"wJ" = (
/obj/structure/marker_beacon/cerulean,
/turf/open/floor/plating/airless,
/area/space)
"wW" = (
/obj/structure/cable,
/obj/structure/chair/sofa/left/brown{
	dir = 4
	},
/turf/open/floor/plating,
/area/space)
"xg" = (
/obj/effect/decal/cleanable/dirt,
/obj/structure/chair/stool/directional/north,
/obj/structure/sign/poster/contraband/random/directional/west,
/turf/open/floor/iron/small,
/area/space)
"xu" = (
/obj/structure/cable,
/obj/effect/turf_decal/tile/blue/fourcorners,
/turf/open/floor/iron,
/area/space)
"xF" = (
/obj/effect/decal/cleanable/dirt,
/obj/item/toy/balloon/syndicate,
/turf/open/floor/plating,
/area/space)
"xY" = (
/obj/machinery/airalarm/directional/west,
/obj/structure/closet/crate/secure/freezer/commsagent,
/obj/effect/mapping_helpers/airalarm/syndicate_access,
/turf/open/floor/plating,
/area/space)
"yo" = (
/obj/effect/decal/cleanable/dirt,
/obj/effect/turf_decal/tile/red/opposingcorners,
/turf/open/floor/iron/dark,
/area/space)
"yp" = (
/obj/structure/cable,
/obj/machinery/atmospherics/pipe/smart/manifold4w/supply/hidden/layer4,
/obj/machinery/atmospherics/components/unary/vent_scrubber/on/layer2,
/obj/effect/turf_decal/tile/red/opposingcorners,
/turf/open/floor/iron/dark,
/area/space)
"yD" = (
/obj/machinery/atmospherics/pipe/smart/manifold4w/supply/hidden/layer4,
/obj/machinery/meter/layer4,
/turf/open/floor/plating,
/area/space)
"yF" = (
/obj/structure/table,
/obj/item/toy/figure/dsquad{
	pixel_x = -7
	},
/obj/structure/desk_bell{
	pixel_y = -1;
	pixel_x = 9
	},
/turf/open/floor/iron,
/area/space)
"yO" = (
/obj/structure/sign/warning/vacuum/external/directional/west,
/obj/structure/cable,
/obj/machinery/light/small/red/directional/east,
/turf/open/floor/plating,
/area/space)
"zQ" = (
/obj/structure/sign/nanotrasen{
	pixel_y = 32
	},
/obj/structure/lattice/catwalk,
/obj/structure/marker_beacon/cerulean,
/turf/template_noop,
/area/space)
"Af" = (
/obj/effect/decal/cleanable/dirt,
/obj/machinery/atmospherics/pipe/smart/manifold4w/supply/hidden/layer4,
/obj/effect/turf_decal/tile/blue/half/contrasted,
/turf/open/floor/iron,
/area/space)
"At" = (
/obj/machinery/atmospherics/pipe/smart/manifold4w/scrubbers/hidden/layer2,
/obj/structure/cable,
/turf/open/floor/plating,
/area/space)
"AN" = (
/turf/open/floor/plating/airless,
/area/space)
"BR" = (
/obj/structure/cable,
/turf/open/floor/plating,
/area/space)
"BS" = (
/obj/structure/table,
/obj/item/flashlight{
	pixel_y = -12
	},
/obj/item/storage/toolbox/syndicate,
/obj/effect/turf_decal/tile/red/opposingcorners,
/turf/open/floor/iron/dark,
/area/space)
"BX" = (
/obj/structure/table,
/obj/item/paper/fluff/ruins/listeningstation/briefing,
/obj/machinery/newscaster/directional/east,
/obj/effect/turf_decal/tile/red/opposingcorners,
/turf/open/floor/iron/dark,
/area/space)
"CD" = (
/obj/effect/decal/cleanable/dirt,
/obj/structure/frame/machine,
/obj/item/circuitboard/machine/telecomms/receiver,
/turf/open/floor/iron/dark,
/area/space)
"CR" = (
/obj/structure/extinguisher_cabinet/directional/west,
/turf/open/floor/plating,
/area/space)
"Di" = (
/obj/item/stack/sheet/iron/twenty,
/obj/structure/closet/crate,
/obj/item/stock_parts/subspace/ansible,
/obj/item/stock_parts/servo,
/obj/item/stock_parts/servo,
/obj/item/stock_parts/servo,
/obj/item/stack/cable_coil,
/turf/open/floor/plating,
/area/space)
"DZ" = (
/obj/structure/sign/poster/official/nanotrasen_logo/directional/north,
/obj/effect/turf_decal/tile/blue,
/turf/open/floor/iron,
/area/space)
"Ea" = (
/obj/item/radio/intercom/directional/east{
	freerange = 1
	},
/obj/machinery/computer/camera_advanced{
	dir = 8
	},
/obj/effect/turf_decal/tile/red/opposingcorners,
/turf/open/floor/iron/dark,
/area/space)
"Es" = (
/obj/effect/decal/cleanable/dirt,
/obj/item/circuitboard/machine/telecomms/processor,
/obj/item/stock_parts/servo,
/obj/item/stock_parts/servo,
/obj/item/stock_parts/servo,
/obj/structure/rack,
/obj/item/stock_parts/subspace/filter,
/obj/item/stock_parts/subspace/treatment,
/obj/item/stock_parts/subspace/treatment,
/obj/item/stock_parts/subspace/analyzer,
/obj/item/stock_parts/subspace/amplifier,
/turf/open/floor/plating,
/area/space)
"EC" = (
/obj/effect/decal/cleanable/dirt,
/obj/effect/decal/cleanable/dirt,
/obj/structure/table,
/obj/item/storage/medkit/regular,
/obj/item/clothing/neck/stethoscope,
/obj/machinery/atmospherics/pipe/smart/manifold4w/supply/hidden/layer4,
/obj/machinery/light/small/directional/north,
/obj/effect/turf_decal/tile/blue/half/contrasted{
	dir = 4
	},
/turf/open/floor/iron,
/area/space)
"EJ" = (
/obj/machinery/atmospherics/components/unary/vent_pump/on/layer4{
	dir = 1
	},
/turf/open/floor/plating,
/area/space)
"Fn" = (
/obj/structure/closet{
	icon_door = "black";
	name = "wardrobe"
	},
/obj/item/clothing/under/color/black{
	pixel_x = -3;
	pixel_y = 3
	},
/obj/item/clothing/under/color/black{
	pixel_x = 1;
	pixel_y = -1
	},
/obj/item/clothing/head/soft/black{
	pixel_x = -3;
	pixel_y = 3
	},
/obj/item/clothing/head/soft/black{
	pixel_x = 1;
	pixel_y = -1
	},
/obj/item/clothing/gloves/fingerless,
/obj/item/clothing/shoes/sneakers/black{
	pixel_x = -3;
	pixel_y = 3
	},
/obj/item/clothing/shoes/sneakers/black{
	pixel_x = 1;
	pixel_y = -1
	},
/obj/effect/decal/cleanable/dirt,
/turf/open/floor/iron/grimy,
/area/space)
"FB" = (
/obj/structure/cable,
/obj/machinery/atmospherics/pipe/smart/manifold4w/supply/hidden/layer4,
/obj/machinery/atmospherics/components/unary/vent_scrubber/on/layer2{
	dir = 4
	},
/obj/machinery/light/warm/directional/south,
/turf/open/floor/iron/grimy,
/area/space)
"FQ" = (
/obj/effect/decal/cleanable/dirt,
/obj/structure/closet/secure_closet/medical1{
	req_access = list("syndicate")
	},
/obj/item/paper/fluff/ruins/listeningstation/reports/september,
/obj/machinery/atmospherics/pipe/smart/manifold4w/supply/hidden/layer4,
/obj/effect/turf_decal/tile/blue/half/contrasted,
/turf/open/floor/iron,
/area/space)
"Gq" = (
/obj/structure/toilet{
	pixel_y = 18
	},
/obj/effect/decal/cleanable/dirt,
/obj/item/soap/syndie,
/obj/structure/sign/poster/contraband/gorlex_recruitment/directional/west,
/obj/machinery/light/very_dim/directional/east,
/turf/open/floor/iron/showroomfloor,
/area/space)
"He" = (
/obj/machinery/atmospherics/pipe/smart/manifold4w/supply/hidden/layer4,
/turf/open/floor/plating,
/area/space)
"HK" = (
/obj/machinery/atmospherics/pipe/smart/manifold4w/supply/hidden/layer4,
/obj/item/multitool{
	pixel_x = 8;
	pixel_y = 3
	},
/obj/structure/table,
/obj/item/toy/cards/deck/syndicate{
	pixel_x = -5;
	pixel_y = 1
	},
/turf/open/floor/plating,
/area/space)
"HY" = (
/obj/machinery/door/airlock/external/ruin{
	id_tag = "syndie_listeningpost_external"
	},
/obj/effect/mapping_helpers/airlock/cyclelink_helper_multi{
	cycle_id = "syndicate_comms_base"
	},
/obj/structure/fans/tiny,
/obj/effect/turf_decal/stripes/line{
	dir = 8
	},
/obj/effect/turf_decal/stripes/line{
	dir = 4
	},
/obj/structure/cable,
/turf/open/floor/plating,
/area/space)
"IG" = (
/obj/machinery/atmospherics/pipe/smart/manifold4w/scrubbers/hidden/layer2,
/obj/structure/cable,
/obj/structure/reagent_dispensers/plumbed{
	name = "Syndicate Ceritified Drinking Water";
	desc = "Who knew water could taste so good?"
	},
/obj/effect/mapping_helpers/burnt_floor,
/turf/open/floor/plating,
/area/space)
"Je" = (
/obj/machinery/power/smes{
	charge = 5e+006
	},
/obj/effect/turf_decal/stripes/line{
	dir = 10
	},
/obj/structure/cable,
/turf/open/floor/plating,
/area/space)
"Jx" = (
/obj/effect/turf_decal/tile/blue{
	dir = 8
	},
/turf/open/floor/iron,
/area/space)
"KE" = (
/obj/effect/mob_spawn/corpse/human/syndicatecommando/lessenedgear,
/turf/open/misc/asteroid/airless,
/area/space)
"KJ" = (
/obj/structure/frame/machine,
/turf/open/floor/iron/dark,
/area/space)
"Lr" = (
/obj/structure/table/wood,
/obj/item/paper/fluff/ruins/listeningstation/reports/november,
/obj/item/crowbar/red,
/obj/machinery/airalarm/directional/west,
/obj/effect/mapping_helpers/airalarm/syndicate_access,
/turf/open/floor/iron/grimy,
/area/space)
"Ms" = (
/obj/effect/decal/cleanable/dirt,
/obj/machinery/atmospherics/pipe/smart/manifold4w/supply/hidden/layer4,
/turf/open/floor/iron/small,
/area/space)
"MA" = (
/obj/structure/cable,
/obj/effect/turf_decal/tile/red/opposingcorners,
/turf/open/floor/iron/dark,
/area/space)
"MU" = (
/obj/structure/cable,
/obj/machinery/atmospherics/pipe/smart/manifold4w/supply/hidden/layer4,
/obj/machinery/atmospherics/pipe/smart/manifold4w/scrubbers/hidden/layer2,
/turf/open/floor/iron/grimy,
/area/space)
"NP" = (
/obj/machinery/atmospherics/components/unary/passive_vent/layer2{
	desc = "Doesn't seem to be connected to anything."
	},
/turf/open/floor/iron,
/area/space)
"Ow" = (
/obj/structure/closet/crate/bin,
/obj/effect/decal/cleanable/dirt,
/obj/machinery/atmospherics/pipe/smart/manifold4w/supply/hidden/layer4,
/obj/machinery/firealarm/directional/north,
/turf/open/floor/iron/small,
/area/space)
"OD" = (
/obj/effect/decal/cleanable/dirt,
/obj/effect/decal/cleanable/ash,
/turf/open/floor/plating,
/area/space)
"ON" = (
/obj/structure/table,
/obj/item/paper/pamphlet/centcom/visitor_info,
/obj/effect/turf_decal/tile/blue/half/contrasted{
	dir = 4
	},
/turf/open/floor/iron,
/area/space)
"OR" = (
/obj/effect/turf_decal/stripes/line{
	dir = 1
	},
/obj/machinery/atmospherics/pipe/smart/simple/supply/visible/layer4{
	dir = 6
	},
/obj/effect/mapping_helpers/broken_floor,
/turf/open/floor/plating,
/area/space)
"OZ" = (
/obj/effect/decal/cleanable/dirt,
/turf/open/floor/iron/small,
/area/space)
"PC" = (
/obj/structure/cable,
/obj/effect/turf_decal/stripes/line,
/obj/machinery/atmospherics/pipe/smart/manifold4w/supply/hidden/layer4,
/obj/machinery/atmospherics/pipe/smart/manifold4w/scrubbers/hidden/layer2,
/obj/effect/turf_decal/tile/red/opposingcorners,
/turf/open/floor/iron/dark,
/area/space)
"PF" = (
/obj/structure/cable,
/obj/effect/decal/cleanable/dirt,
/turf/open/floor/iron/small,
/area/space)
"PS" = (
/obj/effect/turf_decal/bot_red,
/obj/structure/tank_frame,
/turf/open/floor/plating,
/area/space)
"QC" = (
/obj/machinery/atmospherics/pipe/smart/manifold4w/scrubbers/hidden/layer2,
/turf/open/floor/plating,
/area/space)
"QE" = (
/obj/machinery/telecomms/hub,
/turf/open/floor/plating,
/area/space)
"Rc" = (
/obj/machinery/atmospherics/pipe/smart/manifold4w/supply/hidden/layer4,
/obj/machinery/atmospherics/pipe/smart/manifold4w/scrubbers/hidden/layer2,
/obj/structure/cable,
/turf/open/floor/plating,
/area/space)
"Rk" = (
/obj/machinery/telecomms/server,
/turf/open/floor/iron/dark,
/area/space)
"Rp" = (
/obj/structure/cable,
/obj/machinery/atmospherics/pipe/smart/manifold4w/scrubbers/hidden/layer2,
/turf/open/floor/plating,
/area/space)
"Rq" = (
/obj/docking_port/stationary{
	dir = 8;
	dwidth = 4;
	height = 5;
	shuttle_id = "caravansyndicate1_listeningpost";
	name = "Syndicate Listening Post";
	width = 9
	},
/turf/template_noop,
/area/space)
"RO" = (
/obj/machinery/atmospherics/pipe/smart/simple/supply/visible/layer4,
/obj/item/stock_parts/servo{
	pixel_y = 7;
	pixel_x = -1
	},
/obj/item/stock_parts/micro_laser{
	pixel_x = -6;
	pixel_y = -5
	},
/turf/open/floor/plating,
/area/space)
"RR" = (
/turf/closed/wall/r_wall,
/area/space)
"Sh" = (
/obj/machinery/firealarm/directional/east,
/obj/structure/filingcabinet,
/obj/item/paper/fluff/ruins/listeningstation/receipt,
/obj/item/paper/fluff/ruins/listeningstation/reports/may,
/obj/item/paper/fluff/ruins/listeningstation/reports/april,
/obj/item/paper/fluff/ruins/listeningstation/reports/march,
/obj/item/paper/fluff/ruins/listeningstation/reports/july,
/obj/effect/decal/cleanable/dirt,
/obj/effect/turf_decal/tile/red/opposingcorners,
/turf/open/floor/iron/dark,
/area/space)
"Sm" = (
/obj/effect/decal/cleanable/dirt,
/obj/item/stock_parts/servo{
	pixel_y = 8;
	pixel_x = 4
	},
/obj/item/circuitboard/machine/telecomms/bus{
	pixel_x = -1;
	pixel_y = -4
	},
/turf/open/floor/plating,
/area/space)
"Sq" = (
/obj/effect/baseturf_helper/asteroid/airless,
/turf/closed/wall/r_wall,
/area/space)
"SI" = (
/obj/machinery/atmospherics/pipe/smart/manifold4w/scrubbers/hidden/layer2,
/turf/closed/wall/r_wall,
/area/space)
"Ti" = (
/obj/structure/lattice/catwalk,
/obj/structure/sign/nanotrasen{
	pixel_y = -32
	},
/obj/structure/marker_beacon/cerulean,
/turf/template_noop,
/area/space)
"Tr" = (
/obj/structure/table,
/obj/item/food/chocolatebar{
	pixel_y = 8
	},
/obj/item/storage/fancy/cigarettes/cigpack_syndicate{
	pixel_x = -3
	},
/obj/item/lighter{
	pixel_x = 7;
	pixel_y = -3
	},
/turf/open/floor/plating,
/area/space)
"TA" = (
/obj/structure/cable,
/obj/effect/decal/cleanable/dirt,
/obj/effect/turf_decal/tile/blue/anticorner/contrasted,
/turf/open/floor/iron,
/area/space)
"TN" = (
/obj/machinery/power/port_gen/pacman{
	anchored = 1
	},
/obj/effect/turf_decal/delivery,
/turf/open/floor/plating,
/area/space)
"Ue" = (
/obj/structure/cable,
/obj/machinery/atmospherics/components/unary/vent_pump/on/layer4,
/obj/effect/turf_decal/tile/red/opposingcorners,
/turf/open/floor/iron/dark,
/area/space)
"Ug" = (
/obj/effect/decal/cleanable/dirt,
/obj/item/kirbyplants/random,
/turf/open/floor/iron,
/area/space)
"Uj" = (
/obj/effect/decal/cleanable/dirt,
/obj/structure/cable,
/obj/effect/turf_decal/tile/blue/half/contrasted,
/turf/open/floor/iron,
/area/space)
"UI" = (
/turf/closed/mineral/random,
/area/space)
"UZ" = (
/obj/effect/spawner/random/trash/mess,
/obj/machinery/atmospherics/components/unary/vent_pump/on/layer4,
/turf/open/floor/iron/grimy,
/area/space)
"VA" = (
/turf/open/floor/iron/dark,
/area/space)
"VE" = (
/obj/machinery/power/apc/auto_name/directional/east,
/obj/effect/mapping_helpers/apc/syndicate_access,
/obj/structure/cable,
/turf/open/floor/plating,
/area/space)
"VH" = (
/turf/template_noop,
/area/space)
"Ww" = (
/obj/structure/table,
/obj/item/flashlight/lantern/syndicate{
	on = 1
	},
/turf/open/floor/iron,
/area/space)
"WN" = (
/obj/machinery/power/terminal{
	dir = 4
	},
/obj/structure/reagent_dispensers/fueltank,
/obj/effect/turf_decal/delivery,
/turf/open/floor/plating,
/area/space)
"WX" = (
/obj/structure/cable,
/obj/effect/decal/cleanable/dirt,
/obj/machinery/atmospherics/pipe/smart/manifold4w/supply/hidden/layer4,
/obj/machinery/atmospherics/pipe/smart/manifold4w/scrubbers/hidden/layer2,
/turf/open/floor/iron/small,
/area/space)
"Xj" = (
/obj/structure/table,
/obj/item/folder/red,
/obj/item/pen/red,
/turf/open/floor/iron,
/area/space)
"Xz" = (
/obj/item/stack/sheet/iron/twenty,
/obj/item/stack/sheet/glass{
	amount = 10
	},
/obj/item/stack/rods/ten,
/obj/effect/decal/cleanable/dirt,
/obj/item/storage/box/lights/bulbs,
/obj/item/stack/sheet/mineral/plasma{
	amount = 30
	},
/obj/item/stock_parts/cell/high,
/obj/machinery/light/small/directional/east,
/obj/structure/closet/crate,
/obj/effect/turf_decal/delivery,
/obj/structure/cable,
/obj/machinery/atmospherics/pipe/smart/manifold4w/supply/hidden,
/turf/open/floor/plating,
/area/space)
"XM" = (
/obj/structure/cable,
/obj/structure/chair/office{
	dir = 4
	},
/obj/effect/decal/cleanable/dirt,
/obj/machinery/atmospherics/pipe/smart/manifold4w/supply/hidden/layer4,
/obj/effect/turf_decal/tile/red/opposingcorners,
/turf/open/floor/iron/dark,
/area/space)
"XQ" = (
/obj/machinery/airalarm/directional/east,
/obj/machinery/computer/message_monitor{
	dir = 8
	},
/obj/item/paper/monitorkey,
/obj/effect/turf_decal/tile/red/opposingcorners,
/obj/effect/mapping_helpers/airalarm/syndicate_access,
/turf/open/floor/iron/dark,
/area/space)
"XR" = (
/obj/structure/table,
/obj/item/paper/fluff/ruins/listeningstation/reports/september,
/obj/item/storage/box/donkpockets{
	pixel_x = -2;
	pixel_y = 6
	},
/obj/item/storage/box/donkpockets{
	pixel_x = 2
	},
/turf/open/floor/iron/small,
/area/space)
"Yn" = (
/obj/structure/table,
/obj/item/paper_bin,
/obj/item/pen/edagger,
/obj/item/reagent_containers/cup/glass/waterbottle{
	pixel_x = 10;
	pixel_y = 16
	},
/turf/open/floor/plating,
/area/space)
"Zz" = (
/obj/structure/cable,
/turf/open/floor/iron,
/area/space)
"ZJ" = (
/obj/structure/curtain,
/obj/effect/decal/cleanable/dirt,
/turf/open/floor/iron/showroomfloor,
/area/space)
"ZZ" = (
/obj/structure/cable,
/obj/effect/decal/cleanable/dirt,
/obj/machinery/atmospherics/pipe/smart/manifold4w/scrubbers/hidden/layer2,
/turf/open/floor/iron/small,
/area/space)

(1,1,1) = {"
VH
VH
VH
VH
VH
VH
VH
VH
VH
VH
VH
VH
VH
VH
VH
VH
VH
VH
VH
VH
VH
VH
VH
VH
VH
"}
(2,1,1) = {"
VH
VH
VH
VH
VH
VH
VH
VH
VH
VH
VH
VH
VH
Rq
VH
VH
VH
VH
VH
VH
VH
VH
VH
VH
VH
"}
(3,1,1) = {"
VH
VH
VH
VH
VH
VH
VH
UI
UI
UI
UI
mk
ob
sR
jU
mk
UI
VH
VH
VH
VH
VH
VH
VH
VH
"}
(4,1,1) = {"
VH
VH
VH
VH
VH
VH
UI
UI
UI
UI
UI
mk
mk
sR
mk
mk
UI
UI
UI
UI
UI
VH
VH
VH
VH
"}
(5,1,1) = {"
VH
VH
VH
VH
VH
VH
UI
UI
UI
UI
UI
UI
AN
sR
UI
UI
UI
UI
UI
UI
UI
UI
UI
VH
VH
"}
(6,1,1) = {"
VH
VH
VH
VH
VH
VH
VH
UI
UI
UI
UI
UI
wJ
sR
UI
UI
UI
RR
RR
RR
RR
RR
UI
VH
VH
"}
(7,1,1) = {"
VH
VH
VH
VH
VH
VH
UI
UI
UI
UI
UI
UI
UI
sR
sR
mk
UI
RR
lL
Lr
oo
RR
UI
VH
VH
"}
(8,1,1) = {"
VH
VH
VH
VH
VH
VH
UI
UI
UI
UI
UI
UI
UI
AN
sR
AN
UI
RR
Fn
UZ
FB
RR
mk
zQ
VH
"}
(9,1,1) = {"
VH
VH
VH
VH
VH
UI
UI
RR
RR
RR
RR
RR
UI
AN
sR
wJ
UI
RR
ik
mc
MU
RR
UI
VH
VH
"}
(10,1,1) = {"
VH
VH
VH
VH
UI
UI
UI
RR
Ug
Ww
sV
RR
UI
AN
pX
mk
UI
RR
mk
mk
mT
RR
UI
VH
VH
"}
(11,1,1) = {"
VH
VH
VH
Ti
mk
KE
ve
RR
cy
yF
Jx
RR
RR
RR
HY
Sq
UI
RR
cR
FQ
WX
RR
UI
VH
VH
"}
(12,1,1) = {"
VH
VH
UI
sO
UI
mb
UI
RR
DZ
Xj
Uj
Zz
eJ
yO
nL
RR
UI
RR
ge
Af
Rp
RR
UI
VH
VH
"}
(13,1,1) = {"
VH
UI
UI
RR
RR
RR
RR
RR
iq
ON
xu
NP
RR
RR
RR
RR
RR
RR
EC
TA
ru
RR
UI
VH
VH
"}
(14,1,1) = {"
VH
UI
UI
RR
Di
CD
hU
RR
od
Zz
Zz
nI
RR
lH
CR
xg
xY
HK
Ms
BR
QC
RR
UI
UI
VH
"}
(15,1,1) = {"
VH
UI
UI
RR
lv
cK
VA
RR
RR
pd
RR
RR
RR
RR
dl
bj
bj
Ms
EJ
wW
vr
RR
UI
UI
VH
"}
(16,1,1) = {"
VH
UI
UI
RR
bW
QE
cK
dS
yo
MA
uH
BS
ds
mk
Ow
He
rH
cO
OD
PF
QC
RR
UI
UI
VH
"}
(17,1,1) = {"
VH
UI
UI
RR
lv
lv
Sm
RR
pp
Ue
XM
yp
PC
dS
tE
ru
Rp
ZZ
Rp
Rp
lG
RR
UI
UI
VH
"}
(18,1,1) = {"
VH
UI
UI
RR
Es
Rk
KJ
RR
eW
BX
Ea
XQ
Sh
mk
eA
OZ
QC
Yn
lv
aq
Tr
RR
UI
UI
VH
"}
(19,1,1) = {"
VH
VH
UI
RR
RR
RR
RR
RR
mk
mk
mk
mk
mk
mk
qq
rO
bt
lv
xF
BR
cZ
RR
UI
UI
VH
"}
(20,1,1) = {"
VH
VH
UI
UI
ws
UI
UI
RR
oU
OR
te
RO
He
yD
Rc
mk
cH
vL
OZ
VE
XR
RR
UI
VH
VH
"}
(21,1,1) = {"
VH
VH
VH
UI
UI
UI
UI
RR
RR
PS
WN
TN
jl
ls
At
mk
mk
mk
ZJ
RR
RR
RR
UI
VH
VH
"}
(22,1,1) = {"
VH
VH
VH
UI
UI
UI
UI
UI
RR
RR
Je
lX
aV
Xz
IG
mk
Gq
ZJ
wh
RR
UI
UI
UI
VH
VH
"}
(23,1,1) = {"
VH
VH
VH
VH
VH
UI
UI
UI
UI
RR
RR
RR
RR
RR
SI
RR
RR
RR
RR
RR
UI
UI
UI
VH
VH
"}
(24,1,1) = {"
VH
VH
VH
VH
VH
VH
UI
UI
UI
UI
UI
UI
UI
mk
vH
UI
UI
UI
UI
UI
UI
UI
UI
VH
VH
"}
(25,1,1) = {"
VH
VH
VH
VH
VH
VH
VH
VH
VH
VH
VH
VH
VH
tO
VH
VH
VH
VH
VH
VH
VH
VH
VH
VH
VH
"}
